1111111111111
1P11000000C01
1E1C011111001
1000110000001
1111111111111