1111111111111
1E110000000C1
100C011111001
100111P000001
1111111111111