1111111111111
10110000000C1
1111011111001
100111P000001
1111111111111